NO ./test.xpm
SO ./test.xpm
WE ./test.xpm
WE ./test.xpm

C 225,0,0

F 100,100,100

11
101111111
1N1110011
11111111111