NO ./path_to_the_north_texture
SO ./path_to_the_south_texture
WE ./path_to_the_west_texture

F 220,100,0
C 225,30,0

EA ./path_to_the_east_texture
               1111
111111111111111111111111
1111001100000110011001111
11111111111W111111111111111
   111111111111111111111101
                  1111111111
                  1111111011
                  1111111111
